- cursorLineEnd -> alt + ae
- cursorLineStart -> alt + shift + ae
- Navigate between tabls -> ctrl + <num of tab>
- Make new Line above -> ctrl + shift + enter 
- Make new Line below -> ctrl + enter
- Github Copilot: Open Completition Panel -> alt + shitf + enter
- Edit Breakpoint -> shift + f9
- Navigate to last edit location -> alt + shift + ue 
- Navigate to last cursor location -> alt + ue
- Toggle Minimap -> ctrl + shift + p than Toggle Minimap
- move right -> ae
- move left -> oe
- move word right -> ctrl + ae
- move word left -> ctrl + oe
- move line end -> ctrl + shift + ae
- move line start -> ctrl + shift + oe
- move down -> ue
- move up -> shift + ue
- move start of file -> ctrl + shift + ue
- move end of file -> ctrl + ue
- select line down -> shift + ctrl + ue
- Select word right -> ctrl + alt + ae
- select line up -> shift + ctrl + ue
- select word left -> ctrl + alt + oe
- Go to last edit cursor position -> ctrl + shift + z
- move line up -> alt + shift + ue
- move line down -> alt + ue
- toggle tab move focus -> alt + m (changed from ctrl+m) 
- select left (added) -> ctrl + alt + left
- select right (added) -> ctrl + alt + right
- select left word (added) -> ctrl + alt + shift + left
- select right word (added) -> ctrl + alt + shift + right
- Add to second new tab -> alt + right
- duplicate line up -> shift + up
- duplicate line down -> shift + down
- select up -> ctrl + alt + up
- select down -> ctrl + alt + down
- multiple cursor up -> ctrl + alt + shift + up
- multiple cursor down -> ctrl + alt + shift + down
- fold -> ctrl + shift + ß
- unfold -> ctrl + shift + ´

Commit Message: Add collapse all folder and fixed keybindings issues 13.06.2024
- fix problems with move cursor right.
- Collapse all folders -> ctrl + shift + 7

Commit Message: Added scroll up and scroll down keybindings. 19.06.2024
- Removed reStructuredtext.editor.listEditing.onIntendLines = ctrl + ´
- scroll down -> ctrl + ´
- scroll up -> ctrl + ß


